+-+---+--------+
|X|     |     -|
| | --+ | +--  |
| |   | | |    |
| +-- | | |  --+
|     |   |   #|
+-----+---+----+
