+-+---+--------+
|X|     |     -|
| | --+ | +--  |
| |   | | |    |
| +-- | | |  --+
| |   |   |   #|
| ----+ |    --|
|    |  | -----|
|  |   | |     |
+-----+---+----+
