+-+---+--------+
| |     |     -|
| | --+ | +--  |
| |   | | |    |
| +-- | | |  --+
| |X  |   |   #|
| ----+ |    --|
|    |  | -----|
|  |   | |     |
+-----+---+----+
